|---------------------------------------------|
|....|...|...................|................|
|................................|............|
|.....................@.......................|
|...|.|.......................................|
|...|.........................................|
|---------------------------------------------|
