|-----------------------|
|***|**-----------------|
|**-|*@**---------------|
|******-*---------***---|
|--------***------**---*|
|-----------------------|
