|---------------------------------------------|
|***|**---------------------------------------|
|**-|*@**---------------------------***-------|
|******-*---------***-------------****--------|
|--------***------**---*----**|---------------|
|-----------------------***------------|--|---|
|---------------------------------------------|
