|---------------------------------------------|
|....|...|...................|................|
|................................|............|
|............,,,,,,,,,@,,,,,,,,,,.............|
|...|.|..,........,...........................|
|...|.........................................|
|---------------------------------------------|
