|---------------------------------------------|
|....|*..|...................|................|
|.......*........................|............|
|........*...,,,,,,,,,@,,,,,,,,,,.............|
|...|.|..,........,...........................|
|...|...*.....................................|
|---------------------------------------------|
